1 1 1 1 1 1 1 1 1 1 1 1 1 1 1 1
1 8 5 6 1 8 5 6 1 8 5 6 1 0 0 1
1 0 0 0 1 0 0 0 1 0 0 0 1 0 0 1
1 0 0 0 1 0 0 0 1 0 0 0 1 0 0 1
1 4 7 4 2 4 7 4 2 4 7 4 2 0 0 3
1 0 0 0 0 0 0 0 0 0 0 0 0 0 0 0
1 10 0 0 0 0 0 0 0 0 0 0 0 0 0 0
1 4 7 4 1 4 7 4 1 4 7 4 1 0 0 1
1 0 0 0 1 0 0 0 1 0 0 0 1 0 0 1
1 0 0 0 1 0 0 0 1 0 0 0 1 0 0 1
1 9 5 6 1 9 5 6 1 9 5 6 1 0 0 1
2 2 2 2 2 2 2 2 2 2 2 2 2 2 2 2